##internal_ui_grid_menu.txt
##{internal action, button name from ui_grid_menu.txt}
Build	Build
Dismantle	Dismantle
Examine	Examine
Wall	Build_Wall
EnergyConduit	Build_EC
NecroticOrrery	Build_NO
Grave	Build_Grave
R1	R1
R2	R2
R3	R3
Ressurect	Ressurect
RestoreEssence	RestoreEssence
DrainEssence	DrainEssence
DeadAgain	DeadAgain
M_Build	M_Build
M_Spells	M_Spells
M_Research	M_Research
C_Forward	C_Forward
C_Backward	C_Backward
M_Tools	M_Tools
M_Pause	M_Pause
Menu	Menu
Quit	Quit
ClearDead	ClearDead
Demolish	Demolish
MM_Start	MM_Start
MM_Quit	MM_Quit
MM_Hiscores	MM_Hiscores
Guide	Guide
ES_End	ES_End
Tog_EHB	Tog_EHB
Tog_FHB	Tog_FHB
Settings	Settings
ReallySurrender	ReallySurrender
S_Defensive	S_Defensive
S_Research	S_Research
S_Aggressive	S_Aggressive
S_Economy	S_Economy
